10 10
0000001110
1111100010
0000111010
0110000010
0111111110
0000000000
1111101111
0000101000
0110101010
0000000000