8 8
00000000
01101110
01100000
00001110
11101000
00001011
01100000
00001110