10 16
4 5 6 6 6 6 6 5 4 4 4 4 4 5 6 6
4 5 6 6 7 7 6 6 5 5 5 5 5 6 6 7
4 4 5 6 7 7 7 6 6 6 6 6 6 6 7 7
3 4 5 6 6 7 7 7 7 6 6 6 6 7 7 7
2 3 4 5 6 7 7 7 7 7 6 6 6 6 7 7
2 2 3 4 5 6 7 7 7 7 6 6 6 6 6 6
2 2 3 4 5 6 7 7 7 6 6 5 5 5 5 6
2 2 3 4 5 6 6 7 6 6 5 4 4 4 4 5
2 2 3 4 5 6 6 6 6 5 4 4 3 3 4 4
3 3 4 4 5 6 6 6 6 5 4 3 3 3 3 4