10 16
8 5 8 1 8 0 5 4 9 9 1 8 0 2 9 4
6 1 8 1 7 2 7 7 5 9 9 6 5 7 7 7
8 8 7 0 0 8 2 6 0 0 7 9 9 8 9 3
7 3 3 3 2 1 7 3 1 5 0 6 6 9 5 8
3 9 2 2 4 3 8 9 1 3 5 8 2 4 9 0
4 8 8 3 9 7 3 0 7 9 1 8 6 3 5 9
9 1 7 1 2 2 3 1 6 4 9 7 6 9 3 6
5 5 6 4 3 5 0 5 5 8 7 0 1 9 5 0
1 2 4 2 9 5 3 2 0 0 1 9 5 9 1 5
5 2 8 9 0 6 5 4 5 8 7 2 3 9 7 6